map:
........#.......................
........#.......................
#########....................P..
................................
.....................###########
.....................#..........
_________#######################
........... ......=_...........=
..........._...%..=_........@..=
..........._..%...=_...%.......=
=========== ......=_...........=
END
persist:
................................
................................
................................
................................
................................
................................
................................
................................
................................
................................
................................
END
next:END
