map:
........%.........#.............
.................._.............
.................._.......%.....
.................._.............
..................#.............
.......############.............
..................#_____________
..................#.............
..................#..@.....%....
..................#.............
..................#.............
END
persist:
.................=.=============
.................=.............=
.................=.............=
.................=.............=
.................=.............=
...................=============
................................
...............................=
...............................=
...............................=
...................=============
END

