map:
........ .........#.............
........ ........._.............
........ ....%...._.......%.....
........_........._.............
........_.........#.............
.......############.............
..................#_____________
..................#.............
..................#..@.....%....
..................#.............
..................#.............
END
persist:
.........=========.=============
.................=.............=
.................=.............=
.................=.............=
.................=.............=
...................=============
................................
...............................=
.......P.......................=
...............................=
...................=============
END
next:exportEND
