map:
........%.........#.............
.............. ..._.............
.............. ..._.......%.....
.................._.............
..................#.............
.......############.............
..................#_____________
..................#.............
..................#..@.....%....
..................#.............
..................#.............
END
persist:
.................=.=============
.................=.............=
.................=.............=
.................=.............=
.................=.............=
...................=============
................................
...............................=
.......P.......................=
...............................=
...................=============
END
