map:
.........#       .... ..........
.........#     ...... ..........
##########   ........_.......P..
........._..........._..........
....%...._......     ###########
........._.....      #..........
_________#######################
........... ......=_...........=
..........._...%..=_........@..=
......%...._..%...=_...%.......=
=========== ......=_...........=
END
persist:
................................
................................
................................
................................
................................
................................
................................
................................
................................
................................
===========.....................
END
next:END
